###########
##       ##
#         #
#   ###  ##
#   ###  ##
#   #G   ##
#   #######
#   ##  V #
#         #
###########
